{
	"tileset" : "firstFull.png",
	"terrain" : [
		[5, 11, 11, 11, 11, 5, 9, 4, 4, 4, 99, 89, 90, 99, 4],
		[5, 11, 2, 2, 11, 5, 9, 4, 4, 4, 99, 99, 99, 99, 4],
		[5, 11, 5, 11, 11, 5, 9, 4, 4, 4, 4, 4, 4, 4, 4],
		[5, 5, 11, 5, 5, 5, 9, 4, 4, 4, 4, 4, 4, 4, 4, 4],
		[5, 5, 5, 5, 5, 5, 9,4, 4, 4, 4, 4, 55, 4, 4],
		[5, 5, 5, 5, 5, 5, 9, 4, 4, 4, 4, 4, 4, 4, 4],
		[5, 5, 5, 5, 5, 5, 9, 4, 4, 4, 4, 4, 4, 4, 4],
		[5, 5, 5, 5, 5, 5, 9, 10, 10, 10, 10, 10, 10, 10, 10],
		[14, 14, 14, 14, 14, 14, 14, 14, 14, 14, 14, 14, 14, 14, 14],
		[5, 5, 5, 5, 5, 5, 5, 5, 5, 5, 5, 5, 5, 5, 5],
		[5, 5, 5, 5, 5, 5, 5, 5, 5, 5, 5, 5, 5, 5, 5],
		[5, 5, 5, 5, 5, 5, 5, 5, 5, 5, 5, 7, 5, 5, 5],
		[5, 5, 5, 5, 5, 5, 5, 5, 5, 5, 5, 5, 5, 5, 5],
		[5, 5, 5, 5, 5, 5, 5, 5, 5, 5, 5, 5, 5, 5, 5],
		[15, 15, 15, 15, 15, 15, 5, 5, 5, 5, 5, 5, 5, 5, 5]
	]
}

